1,M,2,1,0,0,0,0
2,3,M,1,0,1,1,1
M,2,1,1,0,1,M,1
1,1,0,0,0,1,1,1
0,0,0,0,0,0,0,0
2,3,2,1,0,0,0,0
M,M,M,1,1,1,1,0
2,3,2,1,1,M,1,0