1,M,2,1,0,0,0,1,M
2,3,M,1,0,1,1,1,1
M,2,1,1,0,1,M,1,0
1,1,0,0,0,1,1,2,1
0,0,0,0,0,0,0,1,M
2,3,2,1,0,0,0,1,1
M,M,M,1,1,1,1,0,0
3,4,3,1,1,M,2,2,2
1,M,1,0,1,1,2,M,M